wwwwwwwwwwwwwwwwwwwwwwwwwwwwwwww
wn                            nw
w                              w
w                              w
w                              w
wn                            nw
w                              w
w                              w
w                              w
wn                            nw
w                              w
w                              w
w                              w
wn                            nw
w                              w
w                              w
w                              w
wn                            nw
w                              w
w                              w
w                              w
wn                            nw
w              s               w
wwwwwwwwwwwwwwwwwwwwwwwwwwwwwwww
